

Links lead to information about the country in the World Atlas on this site.  An asterisk (*) indicates a territory and not a independent country; a listing  of all of the independent countries of the world is available. 
Albania - ALB
Algeria - ALG
Andorra	- AND
Argentina - ARG
Armenia	- ARM
Australia - AUS
Austria - AUT
Azerbaijan - AZE
Belarus - BLR
Belgium	- BEL
Bermuda* - BER
Bosnia and Herzegovina - BIH
Brazil - BRA
Bulgaria - BUL
Canada - CAN
Chile - CHI
China - CHN
Costa Rica - CRC
Croatia - CRO
Cyprus - CYP
Czech Republic - CZE
Denmark - DEN
Estonia	- EST
Ethiopia - ETH
Finland - FIN
France - FRA
Georgia - GEO
Germany - GER
Greece - GRE
Hong Kong* - HKG
Hungary	- HUN
Iceland	- ISL
India -	IND
Iran - IRI
Ireland - IRL
Israel - ISR
Italy - ITA
Japan - JPN
Kazakhstan - KAZ
Kenya - KEN
Korea, North (PDR of Korea) - PRK
Korea, South - KOR
Kyrgyzstan - KGZ
Latvia - LAT
Lebanon - LIB
Liechtenstein - LIE
Lithuania - LTU
Luxembourg - LUX
Macedonia - MKD
Madagascar - MAD
Moldova - MDA
Monaco - MON
Mongolia - MGL
Morocco	- MAR
Nepal -	NEP
Netherlands - NED
New Zealand - NZL
Norway - NOR
Pakistan - PAK
Poland - POL
Portugal - POR
Romania - ROM
Russian Federation - RUS
San Marino - SMR
Senegal - SEN
Serbia and Montenegro - SCG
Slovakia - SVK
Slovenia - SLO
South Africa - RSA
Spain - ESP
Sweden - SWE
Switzerland - SUI
Taiwan (Chinese Taipei) - TPE
Tajikistan - TJK
Thailand - THA
Turkey - TUR
Ukraine	- UKR
United Kingdom (Great Britain) - GBR
United States - USA
Uzbekistan - UZB
Venezuela - VEN 
 

Additional Resources 
All 202 Olympic Country Codes
Olympic Game Cities From 1896-2012
Most Populous Countries Not Participating in the Winter Games 
