Sort by: Common Name | Scientific Name | Animal Group

The following is an A to Z list of animal profiles available, sorted by animal group:

African elephant - Loxodonta africana

American beaver - Castor canadensis

American bison - Bison bison

American black bear - Ursus americanus

American moose - Alces americanus

Amur leopard - Panthera pardus orientalis

Arctic wolf - Canis lupus arctos

Asiatic elephant - Elephas maximus

Atlantic white-sided dolphin - Lagenorhynchus acutus

Aye-aye - Daubentonia madagascariensis

Badger, European - Meles meles

Bats - Chiroptera

Beaver, American - Castor canadensis

Bison, American - Bison bison

Black rhinoceros - Diceros bicornis

Black-footed ferret - Mustela nigripes

Blue whale - Balaenoptera musculus

Bobcat - Lynx rufus

Bornean orangutan - Pongo pygmaeus

Bottlenose dolphin - Tursiops truncatus

Brown bear - Ursus arctos

Burchell's zebra - Equus burchellii

Canids - Canidae

Caracal - Caracal caracal

Caribou - Rangifer tarandus

Carnivores - Carnivora

Cats - Felidae

Cetaceans - Cetacea

Cheetah - Acinonyx jubatus

Common dolphin - Delphinus delphis

Common seal - Phoca vitulina

Dugong - Dugong dugong

Dusky dolphin - Lagenorhynchus obscurus

Eland antelope - Tragelaphus oryx

Elephants - Proboscidea

Eurasian lynx - Lynx lynx

European badger - Meles meles

Even-toed ungulates - Artiodactyla

Giant anteater - Myrmecophaga tridactyla

Giant panda - Ailuropoda melanoleuca

Giraffe - Giraffa camelopardalis

Golden-crowned sifaka - Propithecus tattersalli

Gorilla - Gorilla gorilla

Gray whale - Eschrichtius robustus

Hares, rabbits and pikas - Lagomorpha

Hippopotamus - Hippopotamus amphibus

Hyenas - Hyaenidae

Irrawaddy Dolphin - Orcaella brevirostris

Koala - Phascolarctos cinereus

Lemurs, monkeys and apes - Primates

Leopard - Panthera pardus

Lion - Panthera leo

Mammals - Class Mammalia

Manatees - Genus Trichechus

Marsupials - Marsupialia

Meerkat - Suricata suricatta

Moose, American - Alces americanus

Mountain lion - Puma concolor

Mustelids - Family Mustelidae

Neandertal - Homo neanderthalensis

Nine-banded armadillo - Dasypus novemcinctus

Northern bottlenose whale - Hyperoodon ampullatus

Ocelot - Leopardus pardalis

Odd-toed ungulates - Perissodactyla

Orca - Orcinus orca

Panda - Ailuropoda melanoleuca

Panther - Panthera onca

Pigs - Suidae

Polar bear - Ursus maritimus

Primates - Order Primates

Pronghorn - Antilocapra americana

Przewalski's wild horse - Equus caballus przewalskii

Rabbits, hares and pikas - Lagomorpha

Reindeer - Rangifer tarandus

Rhinoceros, black - Diceros bicornis

Rhinoceros, white - Ceratotherium simum

Rodriguez flying fox - Pteropus rodricensis

Siberian tiger - Panthera tigris altaica

Skunks and stink badgers - Mephitidae

Snow leopard - Panthera uncia

Somali wild ass - Equus asinus somalicus

Southern tamandua - Tamandua tetradactyla

Spectacled bear - Tremarctos ornatus

Tapirs - Tapiridae

Tiger - Panthera tigris

Xenarthrans - Xenarthra

Amphisbaenians, lizards and snakes - Squamata

Crocodilians - Crocodilia

Galapagos land iguana - Conolophus subcristatus

Galapagos tortoise - Geochelone nigra

Green sea turtle - Chelonia mydas

Hawksbill sea turtle - Eretmochelys imbricata

Iguana, rhinoceros - Cyclura cornuta

Komodo dragon - Varanus komodoensis

Lava lizard - Microlophus albemarlensis

Leatherback sea turtle - Dermochelys coriacea

Lizards, amphisbaenians and snakes - Squamata

Loggerhead turtle - Caretta caretta

Marine iguana - Amblyrhynchus cristatus

Reptiles - Reptilia

Rhinoceros iguana - Cyclura cornuta

Turtles and tortoises - Chelonia

Sort by: Common Name | Scientific Name | Animal Group